---------
|     | |
|---| | |
|       |
| --|---|
| |   | |
|   |  S|
---------