-----------
|S    |   |
|---| | | |
|       | |
| --|---| |
| |   |  E|
|   |   |||
-----------