------------
|S    |    |
|---| | |- |
|       |- |
| --|---|- |
|    |   | |
|--|   |  E|
------------