---------
|S    | |
|---| | |
|       |
| --|---|
| |   | |
|   |   |
---------